rows 33
cols 58
players 2

m %%%%%%%%%%%%%%%%%%%%%%%%%%%%%%%%%%%%%%%%%%%%%%%%%%%%%%%%%%
m %%%%%0%............................................%1%%%%%
m %%%%%%%............................................%%%%%%%
m %%%%%................................................%%%%%
m %%%%%................................................%%%%%
m %%%%%................................................%%%%%
m %%%%%................................................%%%%%
m %%%%%......aa.....bb.................................%%%%%
m %%%%%......aa.....bb.................................%%%%%
m %%%%%......aa.....bb.................................%%%%%
m %%%%%......aa.....bb.................................%%%%%
m %%%%%......aa.....bb.................................%%%%%
m %%%%%......aa.....bb.................................%%%%%
m %%%%%......aa.....bb.................................%%%%%
m %%%%%......aa.....bb.................................%%%%%
m %%%%%......aa.....bb.................................%%%%%
m %%%%%......aa.....bb.................................%%%%%
m %%%%%......aa.....bb.................................%%%%%
m %%%%%......aa.....bb.................................%%%%%
m %%%%%......aa.....bb.................................%%%%%
m %%%%%......aa.....bb.................................%%%%%
m %%%%%......aa.....bb.................................%%%%%
m %%%%%......aa.....bb.................................%%%%%
m %%%%%................................................%%%%%
m %%%%%................................................%%%%%
m %%%%%................................................%%%%%
m %%%%%................................................%%%%%
m %%%%%................................................%%%%%
m %%%%%................................................%%%%%
m %%%%%................................................%%%%%
m %%%%%................................................%%%%%
m %%%%%................................................%%%%%
m %%%%%%%%%%%%%%%%%%%%%%%%%%%%%%%%%%%%%%%%%%%%%%%%%%%%%%%%%%