rows 33
cols 59
players 2

m %%%%%%%%%%%%%%%%%%%%%%%%%%%%%%%%%%%%%%%%%%%%%%%%%%%%%%%%%%%
m %%%%%0%.............................................%1%%%%%
m %%%%%%%.............................................%%%%%%%
m %%%%%.................................................%%%%%
m %%%%%.................................................%%%%%
m %%%%%.................................................%%%%%
m %%%%%.................................................%%%%%
m %%%%%......a.....b....................................%%%%%
m %%%%%.....a.....b.....................................%%%%%
m %%%%%......a.....b....................................%%%%%
m %%%%%.....a.....b.....................................%%%%%
m %%%%%......a.....b....................................%%%%%
m %%%%%.....a.....b.....................................%%%%%
m %%%%%......a.....b....................................%%%%%
m %%%%%.....a.....b.....................................%%%%%
m %%%%%......a.....b....................................%%%%%
m %%%%%.....a.....b.....................................%%%%%
m %%%%%......a.....b....................................%%%%%
m %%%%%.....a.....b.....................................%%%%%
m %%%%%......a.....b....................................%%%%%
m %%%%%.....a.....b.....................................%%%%%
m %%%%%......a.....b....................................%%%%%
m %%%%%.....a.....b.....................................%%%%%
m %%%%%.................................................%%%%%
m %%%%%.................................................%%%%%
m %%%%%.................................................%%%%%
m %%%%%.................................................%%%%%
m %%%%%.................................................%%%%%
m %%%%%.................................................%%%%%
m %%%%%.................................................%%%%%
m %%%%%.................................................%%%%%
m %%%%%.................................................%%%%%
m %%%%%%%%%%%%%%%%%%%%%%%%%%%%%%%%%%%%%%%%%%%%%%%%%%%%%%%%%%%