rows 33
cols 58
players 2

m %%%%%%%%%%%%%%%%%%%%%%%%%%%%%%%%%%%%%%%%%%%%%%%%%%%%%%%%%%
m %%%%%0%............................................%B%%%%%
m %%%%%%%............................................%%%%%%%
m %%%%%................................................%%%%%
m %%%%%........a.......................................%%%%%
m %%%%%.......a%a......................................%%%%%
m %%%%%........a...............aaa.....................%%%%%
m %%%%%........................aaa.....................%%%%%
m %%%%%........%%%.............aaa.....................%%%%%
m %%%%%........%a%.....................................%%%%%
m %%%%%........%%%.....................................%%%%%
m %%%%%................................................%%%%%
m %%%%%................................................%%%%%
m %%%%%................................................%%%%%
m %%%%%................................................%%%%%
m %%%%%......a0.......a1...............................%%%%%
m %%%%%................................................%%%%%
m %%%%%................................................%%%%%
m %%%%%................................................%%%%%
m %%%%%...............%%%%%............................%%%%%
m %%%%%.................a..............................%%%%%
m %%%%%...............%%%%%............................%%%%%
m %%%%%................................................%%%%%
m %%%%%................................................%%%%%
m %%%%%................................................%%%%%
m %%%%%................................................%%%%%
m %%%%%................................................%%%%%
m %%%%%................................................%%%%%
m %%%%%................................................%%%%%
m %%%%%................................................%%%%%
m %%%%%................................................%%%%%
m %%%%%................................................%%%%%
m %%%%%%%%%%%%%%%%%%%%%%%%%%%%%%%%%%%%%%%%%%%%%%%%%%%%%%%%%%