rows 33
cols 58
players 2

m %%%%%%%%%%%%%%%%%%%%%%%%%%%%%%%%%%%%%%%%%%%%%%%%%%%%%%%%%%
m %%%%%0%............................................%1%%%%%
m %%%%%%%............................................%%%%%%%
m %%%%%................................................%%%%%
m %%%%%................................................%%%%%
m %%%%%................................................%%%%%
m %%%%%................................................%%%%%
m %%%%%................................................%%%%%
m %%%%%................................................%%%%%
m %%%%%................................................%%%%%
m %%%%%................................................%%%%%
m %%%%%................................................%%%%%
m %%%%%................................................%%%%%
m %%%%%.....................a.b........................%%%%%
m %%%%%......................a.b.......................%%%%%
m %%%%%.....................a.b........................%%%%%
m %%%%%......................a.b.......................%%%%%
m %%%%%................................................%%%%%
m %%%%%................................................%%%%%
m %%%%%................................................%%%%%
m %%%%%................................................%%%%%
m %%%%%................................................%%%%%
m %%%%%................................................%%%%%
m %%%%%................................................%%%%%
m %%%%%................................................%%%%%
m %%%%%................................................%%%%%
m %%%%%................................................%%%%%
m %%%%%................................................%%%%%
m %%%%%................................................%%%%%
m %%%%%................................................%%%%%
m %%%%%................................................%%%%%
m %%%%%................................................%%%%%
m %%%%%%%%%%%%%%%%%%%%%%%%%%%%%%%%%%%%%%%%%%%%%%%%%%%%%%%%%%